"filename", "language", "PHP", "comment", "blank", "total"
"e:\Project\miniapp\learning\delivery\B Boss\Boss Deliver_backup\wxcloudrun-thinkphp-apache\app\controller\Dashboard.php", "PHP", 10, 0, 9, 19
"e:\Project\miniapp\learning\delivery\B Boss\Boss Deliver_backup\wxcloudrun-thinkphp-apache\app\controller\Getcode.php", "PHP", 40, 17, 28, 85
"e:\Project\miniapp\learning\delivery\B Boss\Boss Deliver_backup\wxcloudrun-thinkphp-apache\app\controller\Getid.php", "PHP", 15, 1, 5, 21
"e:\Project\miniapp\learning\delivery\B Boss\Boss Deliver_backup\wxcloudrun-thinkphp-apache\app\controller\Index.php", "PHP", 77, 22, 11, 110
"e:\Project\miniapp\learning\delivery\B Boss\Boss Deliver_backup\wxcloudrun-thinkphp-apache\app\controller\Logout.php", "PHP", 20, 2, 5, 27
"e:\Project\miniapp\learning\delivery\B Boss\Boss Deliver_backup\wxcloudrun-thinkphp-apache\app\controller\Nazmulshuvo.php", "PHP", 10, 0, 9, 19
"e:\Project\miniapp\learning\delivery\B Boss\Boss Deliver_backup\wxcloudrun-thinkphp-apache\app\controller\Practicedb.php", "PHP", 47, 0, 19, 66
"e:\Project\miniapp\learning\delivery\B Boss\Boss Deliver_backup\wxcloudrun-thinkphp-apache\app\controller\Saveandgetinfo.php", "PHP", 48, 18, 17, 83
"e:\Project\miniapp\learning\delivery\B Boss\Boss Deliver_backup\wxcloudrun-thinkphp-apache\app\controller\Test.php", "PHP", 74, 49, 27, 150
"e:\Project\miniapp\learning\delivery\B Boss\Boss Deliver_backup\wxcloudrun-thinkphp-apache\app\controller\product.php", "PHP", 27, 23, 21, 71
"Total", "-", 368, 132, 151, 651